00000000000000000000000000000000000000000000000000000000000000000000000000000000000000000000000
0000000000000abc0000000000000000000000000000000000000000000000000000000000000000000000000000000
00000abc00000def0000000000000000000000000000000000000000000000000000000000000000000000000000000
00000def00000000000000000abc0000000000000000000000000000000000000000000000000000000000000000000
0000000000000000000000000def0000000000000000000000000000000000000000000000000000000000000000000
00000000000000000000000000000000000000000000000000000000000000000000000000000000000000000000000
00000000000000000000000000000000000000000000000000000000000000000000000000000000000000000000000
00000000000000000000000000000000000000000000000000000000000000000000000000000000000000000000000
00000000000000000000000000000000000000000000000000000000000000000000000000000000000000000000000
00000000000000000000000000000000000000000000000000000000000000000000000000000000000000000000000
00000000000000000000000000000000000000000000000000000000000000000000000000000000000000000000000
00000000000000000000000000000000000000000000000000000000000000000000000000000000000000000000000
00222200000000000000000000222220000000000000000000000000000000000000000000000000000000000000000
22111122222222222222222222211122222222222222222222222222222222222222222222222222222222222222222	
11111111111111111111111111111111111111111111111111111111111111111111111111111111111111111111111
11111111111111111111111111111111111111111111111111111111111111111111111111111111111111111111111
11111111111111111111111111111111111111111111111111111111111111111111111111111111111111111111111
11111111111111111111111111111111111111111111111111111111111111111111111111111111111111111111111
